##################
# #      # #  #  #
# # #  # #       #
##l #  #    l    #
# # #  # # #  #  #
# # # #  #   #  ##
#                #
#  # # # # #     #
##################